21 22
XXXXXXXXXXXXXXXXXXXXX
X*                 *X
X                   X
X                   X
X.XXXXXXXXXXXXXXXXX.X
X.X*.............*X.X
X.X.XXXXXXXXXXXXX.X.X
X.X.X*.........*X.X.X
X.X.X.XXXXXXXXX.X.X.X
X.X.X.X.......X.X.X.X
X.X.X.X.XXXXX.X.X.X.X
X. .X.X.X   X.X.X. .X
X. .X.X.X   X.X.X. .X
X.X.X.X.X   X.X.X.X.X
X.X.X.X.X P X.X.X.X.X
X.X.X.X.X   X.X.X.X.X
X.X.X.X.X   X.X.X.X.X
X.X.X.X.X   X.X.X.X.X
X.X...............X.X
X.XXXXXXXXXXXXXXXXX.X
X...................X
XXXXXXXXXXXXXXXXXXXXX
