42 24
XXXXXXXXXXXXXXXXXXXXXXXXXXXXXXXXXXXXXXXXXX
X                                        X
X                                        X
X                                        X
X                                        X
X                                        X
X                                        X
X                                        X
X                                        X
X                                        X
X                                        X
X                                        X
X                                        X
X                  XXX                   X
X                 XX XX                  X
X                XX   XX                 X
X               XX     XX                X
X                                        X
X                                        X
X                                        X
X                                        X
X                                        X
X                                        X
XXXXXXXXXXXXXXXXXXXXXXXXXXXXXXXXXXXXXXXXXX
