40 40
0000000100000000000000000000000000000000
0000000100000000000000000000000000000000
0000000100000000000000000000000000000000
0000000100000000000000000000000000000000
0000000111111111111110000000000000000000
0000000001111111111111111111111111111111
0000000000011111011111111000000000000000
0000000000000111101111111110000000000000
0000000000000001110111111111100000000000
0000000000000000011011111111111000000000
0000000000000001111101111111100000000000
0000000000000111111011111110000000000000
0000000000011111110111111000000000000000
0000000001111111101111100000000000000000
0000000111111111011110000000000000000000
0000000111111110111110000000000000000000
0000000111111101111110000000000000000000
0000000111111011111110000000000000000000
0000000111111111111110000000000000000000
1111111111111111111110000000000000000000
0000000011111111111110000000000000000000
0000000001111111111110000000000000000000
0000000000111111111110000000000000000000
0000000000011111111110000000000000000000
0000000000001111111110000000000000000000
0000000000001111111110000000000000000000
0000000000000111111110000000000000000000
0000000000000011111110000000000000000000
0000000000000001111110000000000000000000
0000000000000000111110000000000000000000
0000000000000000011110000000000000000000
0000000000000000001110000000000000000000
0000000000000000000111111111111111111111
0000000000000000000010000000000000000000
0000000000000000111111111111111111111100
0000000000000001111111111111111111111100
0000000000000011000000000000000000000100
0000000000000110000000000000000000000100
0000000000001100000000000000000000000100
0000000000011000000000000000000000000100